r 0 1 1 1
r 1 1 1 1
r 2 1 1 1
d 1 1 1 1
d 2 1 1 1
d 3 1 1 1
d 0 1 1 1
r 3 3 1 1
r 8 1 1 1
d 8 1 1 1
rd 8 1 1 1
d 11 2 1 1
l 12 1 1 1
d 13 1 1 1
d 12 1 1 1
d 6 2 1 1
l 16 1 1 1
l 17 1 1 1
l 18 1 1 1
d 16 1 1 1
d 17 1 1 1
d 18 1 1 1
d 19 1 1 1
r 12 2 1 1
u 24 1 1 1
u 25 1 1 1
u 26 1 1 1
d 24 1 1 1
r -1 1 1 1
u -1 1 1 1
u -1 1 1 1
u -1 1 1 1
u -1 1 1 1
r -1 1 1 1
d -1 1 1 1
d -1 1 1 1
d -1 1 1 1
d -1 1 1 1
r -1 1 1 1
u -1 1 1 1
u -1 1 1 1
u -1 1 1 1
u -1 1 1 1
r -1 1 1 1
d -1 1 1 1
d -1 1 1 1
d -1 1 1 1
d -1 1 1 1
r -1 1 1 1
u -1 1 1 1
u -1 1 1 1
u -1 1 1 1
u -1 1 1 1
r 20 1 1 1
ru -1 1 1 1
r 3 1 1 1
rd -1 1 1 1
rd 0 0.5 1 2
r -1 1 1 2
r -1 1 1 2
r -1 1 1 2
d -1 1 1 2
l -1 1 1 2
l -1 1 1 2
l -1 1 1 2
d -1 1 1 2
r -1 1 1 2
r -1 1 1 2
r -1 1 1 2
d -1 1 1 2
l -1 1 1 2
l -1 1 1 2
l -1 1 1 2
r 8 0.5 1 2
d -1 1 1 2
l -1 1 1 2
r 55 0.5 1 2
r -1 1 1 2
d -1 1 1 2
r 27 0.5 1 2
r -1 1 1 2
d -1 1 1 2
l -1 1 1 2
r 43 0.5 1 2
r -1 1 1 2
d -1 1 1 2
l -1 1 1 2
r 24 0.5 1 2
r -1 1 1 2
d -1 1 1 2
l -1 1 1 2
r 40 0.5 1 2
r -1 1 1 2
d -1 1 1 2
l -1 1 1 2
r 58 0.5 1 3
r -1 1 1 3
r -1 1 1 3
d -1 1 1 3
d -1 1 1 3
d -1 1 1 3
l -1 1 1 3
l -1 1 1 3
u -1 1 1 3
u -1 1 1 3
ld 74 0.5 1 3
ld 78 0.5 1 3
rd 80 0.5 1 3
d -1 1 1 3
d -1 1 1 3
d -1 1 1 3
rd 84 0.5 1 3
d -1 1 1 3
d -1 1 1 3
d -1 1 1 3
