r -1 1 1 1
r -1 1 1 1
d 1 1 1 1
d 0 1 1 1
l -1 1 1 1
d -1 1 1 1
l -1 1 1 1
d 6 1 1 1
r -1 1 1 1
u -1 1 1 1
r -1 1 1 1
d -1 1 1 1
l -1 1 1 1
d 13 1 1 1
r -1 1 1 1
